4 4 4 4 4 4 4 4 4 4 4 4 4 4 4 4 4 4 4 4 4 4 4 4 4 4 4 4 4 4 4 4 4 4 4 4 4 4 4 4 4 4 4 4 4 4 4 4 4 4 4 4 4 4 4 4
4 4 4 4 4 4 4 4 4 4 4 4 4 4 4 4 4 4 4 4 4 4 4 4 4 4 4 4 4 4 4 4 4 4 4 4 4 4 4 4 4 4 4 4 4 4 4 4 4 4 4 4 4 4 4 4
4 4 4 4 4 4 4 4 4 4 4 4 4 4 4 4 4 4 4 4 4 4 4 4 4 4 4 4 4 4 4 4 4 4 4 4 4 4 4 4 4 4 4 4 4 4 4 4 4 4 4 4 4 4 4 4
4 4 4 4 4 4 4 4 4 4 4 4 4 4 4 4 4 4 4 4 4 4 4 4 4 4 4 4 4 4 4 4 4 4 4 4 4 4 4 4 4 4 4 4 4 4 4 4 4 4 4 4 4 4 4 4
4 4 4 4 7 7 7 7 7 7 4 4 7 7 7 7 4 4 4 4 4 4 4 4 4 4 4 4 4 4 4 4 4 4 4 4 4 4 4 4 4 4 4 4 4 4 4 4 4 4 4 4 4 4 4 4
4 4 4 4 7 7 4 7 7 7 7 4 7 7 4 7 1 7 7 7 7 7 7 7 4 4 4 4 4 4 4 4 4 4 4 4 4 4 4 4 4 4 4 4 4 4 4 4 4 4 4 4 4 4 4 4
4 4 4 4 7 4 4 4 4 4 7 7 7 7 4 7 1 7 7 7 7 7 7 7 7 4 4 4 4 4 4 4 4 4 4 4 4 4 4 4 4 4 4 4 4 4 4 4 4 4 4 4 4 4 4 4
4 4 4 4 7 7 7 7 7 4 4 7 4 7 4 7 4 4 4 4 4 4 4 4 7 7 4 4 4 4 4 4 4 4 4 4 4 4 4 4 4 4 4 4 4 4 4 4 4 4 4 4 4 4 4 4
4 4 4 4 7 4 4 4 7 7 4 4 4 7 4 7 4 4 4 4 4 4 4 4 7 7 4 4 4 4 4 4 4 4 4 4 4 4 4 4 4 4 4 4 4 4 4 4 4 4 4 4 4 4 4 4
4 4 4 4 7 7 7 4 4 7 7 4 4 7 4 7 4 4 4 4 4 4 4 4 7 7 4 4 4 4 4 4 4 4 4 4 4 4 4 4 4 4 4 4 4 4 4 4 4 4 4 4 4 4 4 4
4 4 4 4 7 4 7 7 4 7 7 4 4 4 4 7 4 4 4 4 4 4 4 4 7 7 4 4 4 4 4 4 4 4 4 4 4 4 4 4 4 4 4 4 4 4 4 4 4 4 4 4 4 4 4 4
4 4 4 4 7 4 7 7 4 7 7 4 4 4 4 4 4 4 4 4 4 4 4 4 7 7 7 7 7 7 7 7 7 7 7 4 4 4 4 4 4 4 4 4 4 4 4 4 4 4 4 4 4 4 4 4
4 4 4 4 4 4 7 7 4 7 7 4 4 4 4 4 4 4 4 4 4 4 4 4 7 4 4 4 4 4 4 4 4 4 7 7 7 7 4 4 0 0 0 0 0 0 0 0 0 0 0 0 4 4 4 4
4 4 4 4 4 4 4 7 4 7 7 4 4 4 4 4 4 4 4 4 4 4 4 4 7 4 4 4 4 4 4 4 4 4 4 4 4 7 4 4 0 7 7 7 7 7 7 7 7 7 7 0 4 4 4 4
4 4 4 4 4 4 4 4 4 7 7 0 0 0 0 0 0 0 0 0 0 0 4 4 7 4 4 4 4 4 4 4 4 4 4 4 4 7 7 7 1 7 7 7 7 7 7 7 7 7 7 0 4 4 4 4
0 0 0 0 0 0 0 0 0 7 7 8 7 7 7 0 0 0 0 0 0 0 4 4 7 4 4 4 4 4 4 4 4 4 4 4 4 4 4 4 0 7 7 7 7 7 7 7 7 7 7 0 4 4 4 4
0 17 17 17 17 17 0 0 0 7 7 7 7 8 7 0 0 0 0 0 0 0 4 4 7 4 4 4 4 4 4 4 4 4 4 4 4 4 4 4 0 7 7 7 7 7 7 7 7 7 7 0 4 4 4 4
0 17 17 17 17 17 17 17 0 0 0 0 0 7 7 0 0 0 0 0 0 0 4 4 7 7 7 7 7 7 7 4 4 4 4 4 4 4 4 4 0 7 7 7 7 7 7 7 7 7 7 0 4 4 4 4
0 17 17 17 17 17 17 17 17 17 17 17 0 7 8 0 0 0 0 0 0 0 4 4 4 4 4 4 7 7 7 4 4 4 4 4 4 4 4 4 0 7 7 7 7 7 7 7 7 7 7 0 4 4 4 4
0 17 17 17 17 17 17 17 17 17 17 17 17 7 7 0 17 17 17 0 0 0 4 4 4 4 4 4 7 7 7 4 4 4 4 4 4 4 4 4 0 0 0 0 0 0 0 0 0 0 0 0 4 4 4 4
0 0 0 0 0 0 0 0 17 17 17 17 17 8 7 17 17 17 17 17 17 17 4 4 4 4 4 4 4 4 4 4 4 4 4 4 4 4 4 4 4 4 4 4 4 4 4 4 4 4 4 4 4 4 4 4
4 4 4 4 4 4 4 0 17 17 17 17 17 6 6 17 17 17 17 17 17 0 4 4 4 4 4 4 4 4 4 4 4 4 4 4 4 4 4 4 4 4 4 4 4 4 4 4 4 4 4 4 4 4 4 4
4 4 4 4 4 4 4 16 8 7 7 7 7 8 7 8 7 15 5 5 9 16 4 4 4 4 4 4 4 4 4 4 4 4 4 4 4 4 4 4 4 4 4 4 4 4 4 4 4 4 4 4 4 4 4 4
4 4 4 4 4 4 4 16 7 7 8 7 8 7 7 7 7 14 6 6 10 16 4 4 4 4 4 4 4 4 4 4 4 4 4 4 4 4 4 4 4 4 4 4 4 4 4 4 4 4 4 4 4 4 4 4
4 4 4 4 4 4 4 16 8 7 7 7 7 7 8 7 7 14 6 6 10 16 4 4 4 4 4 4 4 4 4 4 4 4 4 4 4 4 4 4 4 4 4 4 4 4 4 4 4 4 4 4 4 4 4 4
4 4 4 4 4 4 4 16 7 7 7 8 7 7 7 7 7 14 6 6 10 16 4 4 4 4 4 4 4 4 4 4 4 4 4 4 4 4 4 4 4 4 4 4 4 4 4 4 4 4 4 4 4 4 4 4
4 4 4 4 4 4 4 16 7 8 7 7 7 8 7 7 8 13 12 12 11 16 4 4 4 4 4 4 4 4 4 4 4 4 4 4 4 4 4 4 4 4 4 4 4 4 4 4 4 4 4 4 4 4 4 4
4 4 4 4 4 4 4 16 7 7 8 7 8 7 7 8 7 7 7 8 7 16 4 4 4 4 4 4 4 4 4 4 4 4 4 4 4 4 4 4 4 4 4 4 4 4 4 4 4 4 4 4 4 4 4 4
4 4 4 4 4 4 4 0 2 2 2 2 2 2 2 2 2 2 2 2 2 3 4 4 4 4 4 4 4 4 4 4 4 4 4 4 4 4 4 4 4 4 4 4 4 4 4 4 4 4 4 4 4 4 4 4
4 4 4 4 4 4 4 4 4 4 4 4 4 4 4 4 4 4 4 4 4 4 4 4 4 4 4 4 4 4 4 4 4 4 4 4 4 4 4 4 4 4 4 4 4 4 4 4 4 4 4 4 4 4 4 4
4 4 4 4 4 4 4 4 4 4 4 4 4 4 4 4 4 4 4 4 4 4 4 4 4 4 4 4 4 4 4 4 4 4 4 4 4 4 4 4 4 4 4 4 4 4 4 4 4 4 4 4 4 4 4 4
4 4 4 4 4 4 4 4 4 4 4 4 4 4 4 4 4 4 4 4 4 4 4 4 4 4 4 4 4 4 4 4 4 4 4 4 4 4 4 4 4 4 4 4 4 4 4 4 4 4 4 4 4 4 4 4
4 4 4 4 4 4 4 4 4 4 4 4 4 4 4 4 4 4 4 4 4 4 4 4 4 4 4 4 4 4 4 4 4 4 4 4 4 4 4 4 4 4 4 4 4 4 4 4 4 4 4 4 4 4 4 4
