19 19 19 19 19 19 19 19 19 19 19 19 19 19 19 19 19 19 19 19 19 19 19 19 19 19 19 19 19 19 19 19 19 19 19 19 19 19 19 19 19 19 19 19 19 19 19 19 19 19 19 19 19 19 19 19 19 19 19 19 19 19 19 19 19 19 19 19 19 19 19 19 19 19 19 19 19 19 19 19 19 19 19 19 19 19 19 19 19 19 19 19 19 19 19 19 19 19 19 19 
19 19 19 19 19 19 19 19 19 19 19 19 19 19 19 19 19 19 19 19 19 19 19 19 19 19 19 19 19 19 19 19 19 19 19 19 19 19 19 19 19 19 19 19 19 19 19 19 19 19 19 19 19 19 19 19 19 19 19 19 19 19 19 19 19 19 60 15 15 15 59 19 19 19 19 19 19 19 19 19 19 19 19 19 19 19 19 19 19 19 19 19 19 19 19 19 19 19 19 19 
19 19 19 19 19 19 19 19 19 19 19 19 19 19 19 19 19 19 19 19 19 60 15 15 15 15 15 15 15 15 15 15 59 19 19 19 19 19 19 19 19 19 19 19 19 19 19 19 19 19 19 19 19 19 19 19 19 19 19 19 19 19 19 19 60 15 14 2 2 2 16 59 19 19 19 19 19 19 19 19 19 19 19 19 19 19 19 19 19 19 19 19 19 19 19 19 19 19 19 19 
19 19 19 19 19 19 19 19 19 19 19 19 19 19 19 19 19 19 60 15 15 14 2 2 2 2 2 2 2 2 2 2 16 15 15 59 19 19 19 19 19 19 19 19 19 19 19 19 19 19 19 19 19 19 19 19 19 19 19 19 19 60 15 15 14 2 2 1 2 2 2 17 19 19 19 19 19 19 19 19 19 19 19 19 19 19 19 19 19 19 19 19 19 19 19 19 19 19 19 19 
19 19 19 19 19 19 19 19 19 19 19 19 19 60 15 15 15 15 14 2 9 2 2 2 2 2 2 2 1 2 2 2 1 2 2 16 15 15 15 15 15 59 19 19 19 19 19 19 19 19 19 19 19 19 19 19 19 19 19 19 60 14 2 2 2 1 1 1 57 11 11 62 19 19 19 19 19 19 19 19 19 19 19 19 19 19 19 19 19 19 19 19 19 19 19 19 19 19 19 19 
19 19 19 19 19 19 19 19 19 19 19 60 15 14 2 2 2 2 2 2 9 1 1 2 2 2 2 2 2 2 2 2 1 2 2 2 2 2 2 2 2 16 15 15 15 15 15 15 15 15 15 15 15 15 15 15 15 15 15 15 14 2 2 2 2 1 2 57 62 19 19 19 19 19 19 19 19 19 19 19 19 19 19 19 19 19 26 37 37 37 37 37 37 25 19 19 19 19 19 19 
19 19 19 19 19 19 19 19 19 19 60 14 2 2 2 2 1 1 1 1 9 2 2 2 2 2 2 2 1 2 2 2 2 2 2 2 2 2 2 2 2 2 2 9 2 2 2 2 2 2 2 2 2 2 2 2 2 2 2 76 74 75 2 2 2 2 57 62 19 19 19 19 19 19 19 19 19 19 19 19 19 19 19 19 19 26 29 29 29 29 29 29 29 29 25 19 19 19 19 19 
19 19 19 19 19 19 19 19 19 60 14 2 2 2 2 1 2 2 2 2 9 2 2 2 2 2 2 2 2 1 2 2 2 1 2 2 2 2 2 2 1 1 1 8 2 2 2 2 2 2 2 2 2 2 2 2 2 1 2 2 2 2 2 1 2 57 62 19 19 19 19 19 19 19 19 19 19 19 19 19 19 19 19 19 19 32 29 29 29 29 29 29 29 29 33 19 19 19 19 19 
19 19 19 19 19 19 19 19 60 14 2 2 2 1 1 2 2 2 2 2 9 2 2 1 1 1 2 2 2 1 2 2 2 2 1 2 2 2 2 2 2 2 2 8 2 2 2 2 2 2 2 2 2 1 1 2 2 1 1 1 1 1 1 1 2 17 19 19 19 19 19 19 19 19 19 19 19 19 19 19 19 19 19 19 19 32 29 29 29 29 29 29 29 29 33 19 19 19 19 19 
19 19 19 19 19 19 19 60 14 2 2 2 1 1 2 2 2 2 2 2 9 2 1 1 2 2 2 2 2 2 1 1 2 2 9 8 8 8 9 8 9 8 9 8 1 2 2 2 2 2 2 1 1 1 2 2 2 2 2 2 2 2 2 2 2 17 19 19 19 19 19 19 19 19 19 19 19 19 19 19 19 19 19 19 19 34 29 29 29 29 29 29 29 29 33 19 19 19 19 19 
19 19 19 19 19 19 19 13 2 2 2 2 2 2 2 2 2 1 1 1 7 9 7 9 8 9 5 9 9 5 8 8 8 8 9 2 1 1 2 2 2 2 2 1 1 2 2 1 1 1 1 2 2 2 2 2 2 2 2 2 2 2 2 2 2 16 59 19 19 19 19 19 19 19 19 19 19 19 19 19 19 19 19 19 19 27 36 29 29 29 29 29 29 36 28 19 19 19 19 19 
19 19 19 19 19 19 60 14 2 2 2 2 2 1 1 1 1 1 2 2 2 2 2 2 2 2 2 2 2 2 2 2 2 2 2 2 2 2 2 2 2 2 2 2 1 1 1 2 2 2 2 2 2 2 2 2 57 11 11 58 2 2 1 1 2 2 16 59 19 19 19 19 19 19 19 19 19 19 19 19 19 19 19 19 19 91 91 27 36 29 29 36 28 91 91 19 19 19 19 19 
19 19 19 19 19 19 13 2 2 2 2 2 2 2 2 2 2 2 2 2 2 2 2 2 2 1 1 1 1 1 1 2 2 2 1 1 2 2 2 2 2 2 2 2 2 2 2 1 2 2 2 2 1 1 2 57 62 19 19 64 58 2 2 1 1 2 2 16 59 19 19 19 19 19 19 19 19 19 19 19 19 19 19 19 19 19 19 91 91 32 33 91 91 19 19 19 19 19 19 19 
19 19 19 19 19 19 64 11 11 11 11 11 11 11 11 11 2 2 2 2 2 2 2 2 2 2 2 2 2 2 11 2 2 2 2 1 1 1 1 2 2 2 2 1 1 1 1 1 2 2 2 1 1 2 57 62 19 19 19 19 64 58 2 2 2 1 1 2 16 59 19 19 19 19 19 19 19 19 19 19 19 19 19 19 19 19 19 19 19 32 33 19 93 19 19 19 19 19 19 19 
19 19 19 19 19 19 19 19 58 2 2 2 2 2 2 19 11 11 2 2 2 2 2 2 2 2 2 2 2 2 19 2 2 2 2 2 2 2 1 1 1 2 2 2 1 1 2 2 2 1 1 2 57 11 62 19 19 19 19 19 19 64 11 11 58 2 1 2 2 17 19 19 19 19 19 19 19 19 19 19 19 19 19 19 19 19 19 19 19 32 33 19 19 92 19 19 19 19 19 19 
19 19 19 19 19 19 19 19 64 11 58 2 2 2 1 2 2 2 11 11 2 2 2 2 2 2 2 2 2 11 19 2 2 2 2 2 2 2 2 2 2 2 2 2 2 1 2 2 1 2 57 11 62 19 19 19 19 19 19 19 19 19 19 19 64 58 2 2 2 17 19 19 19 19 19 19 19 19 19 19 19 19 19 19 19 19 19 19 19 32 33 19 19 19 19 19 19 19 19 19 
19 19 19 19 19 19 19 19 19 19 64 58 2 2 1 1 2 2 2 2 11 11 11 2 2 2 2 11 11 19 2 2 2 2 2 2 2 2 2 2 1 2 1 2 2 2 2 2 2 57 62 19 19 19 19 19 19 19 19 19 19 19 19 19 19 64 11 11 11 62 19 19 19 19 19 19 19 19 19 19 19 60 15 15 15 15 15 63 15 32 33 15 15 15 15 15 15 15 15 15 
19 19 19 19 19 19 19 19 19 19 19 64 11 58 2 2 1 1 1 2 2 2 19 11 11 11 11 19 2 2 2 2 2 2 2 1 1 1 1 1 2 1 1 1 1 1 1 2 57 62 19 19 19 19 19 19 19 19 19 19 19 19 19 19 19 19 19 19 19 19 19 19 19 19 19 19 19 19 19 19 60 14 1 2 2 41 1 2 1 32 33 2 2 1 41 1 1 1 2 2 
19 19 19 19 19 19 19 19 19 19 19 19 19 64 58 2 2 2 2 2 2 2 2 2 2 2 2 2 2 2 2 2 2 1 1 1 2 2 2 2 1 1 2 32 33 2 2 57 62 19 19 19 19 19 19 19 19 19 19 19 19 19 19 19 19 19 19 19 19 19 19 19 19 19 19 19 19 19 19 60 14 1 2 1 2 41 1 1 2 52 55 2 1 1 41 2 2 1 1 2 
19 19 19 19 19 19 19 19 19 19 19 19 19 19 64 11 58 2 2 2 2 2 1 1 1 2 2 2 2 2 2 2 2 2 2 2 2 2 2 2 2 2 2 32 33 2 57 62 19 50 19 19 19 19 19 19 19 19 19 19 19 19 19 19 19 19 19 19 19 19 19 19 19 19 19 19 19 19 60 14 1 2 1 1 1 41 2 2 1 52 55 65 1 1 41 1 1 2 1 2 
19 19 19 19 19 19 19 19 19 19 19 19 19 19 19 19 64 11 11 58 2 2 2 2 2 2 1 1 2 2 2 2 2 2 2 2 2 1 1 1 1 2 2 32 33 11 62 19 19 19 50 19 19 19 19 19 19 19 19 19 19 19 19 19 19 19 19 19 19 19 19 19 19 19 19 19 19 60 14 2 2 1 1 2 2 41 2 2 1 52 54 2 2 2 41 1 1 2 1 1 
19 19 19 19 19 19 19 19 50 50 19 19 19 19 19 19 19 19 19 64 11 11 58 2 2 2 2 1 1 1 1 1 2 2 2 2 2 2 2 2 2 18 11 32 29 37 37 25 19 19 19 19 19 19 19 19 19 19 19 19 19 19 19 19 19 19 19 19 19 19 19 60 15 15 15 15 15 14 2 1 1 1 2 2 1 41 1 2 1 52 55 1 1 1 41 1 1 2 2 1 
15 15 15 59 19 50 50 50 50 19 50 19 19 19 19 19 19 19 19 19 19 19 64 11 58 2 2 2 2 2 2 2 2 18 11 11 11 11 11 11 11 62 19 27 36 36 29 33 50 19 19 19 19 19 19 32 19 19 19 19 19 19 19 19 19 19 19 19 19 19 19 13 1 2 1 2 1 1 1 2 2 2 1 1 2 41 2 1 2 52 54 2 1 2 41 2 1 2 1 1 
2 2 2 16 15 15 15 15 15 59 19 50 19 19 19 19 19 19 19 19 19 19 19 19 64 11 11 11 58 2 2 2 2 17 19 19 50 19 19 50 19 19 19 91 94 91 32 33 19 19 50 19 19 19 19 34 33 19 19 19 19 19 19 19 19 19 19 19 19 19 19 13 1 82 82 82 82 82 82 82 82 82 82 82 82 82 82 82 82 86 86 82 82 82 82 82 82 82 82 82 
2 2 2 2 2 2 2 2 2 16 50 50 19 19 19 50 19 19 19 19 19 19 19 19 19 19 19 19 64 58 2 2 2 16 56 59 19 19 19 19 50 19 19 19 19 19 32 33 19 50 19 19 19 19 19 32 31 19 19 19 19 19 19 19 19 19 19 19 19 19 19 13 2 82 82 82 82 82 82 82 82 82 82 82 82 82 82 82 82 86 86 82 82 82 82 82 82 82 82 82 
2 2 2 2 2 2 2 2 2 2 2 17 19 50 19 19 50 19 19 19 19 19 19 19 19 19 19 19 19 64 58 2 2 2 2 16 59 50 19 19 19 93 19 92 19 19 32 33 19 19 19 19 19 19 19 32 33 19 19 19 19 19 19 19 19 19 19 19 19 19 19 13 2 82 82 82 82 82 82 82 82 82 82 82 82 82 82 82 82 86 86 82 82 82 82 82 82 82 82 82 
41 41 41 41 41 41 41 41 41 41 41 17 50 50 19 50 19 19 50 19 19 19 19 19 19 19 19 19 19 19 64 58 2 2 2 2 17 19 19 19 19 19 19 19 19 19 32 29 37 37 37 37 37 37 37 29 33 19 19 19 19 19 19 19 19 19 19 19 19 19 19 13 1 82 82 82 82 82 82 82 82 82 82 82 82 82 82 82 82 87 87 82 82 82 82 82 82 82 82 82 
41 2 2 2 2 2 2 2 2 2 2 16 15 56 56 56 56 15 15 59 19 19 19 19 19 19 19 19 19 19 19 64 11 11 11 11 62 19 50 19 19 19 19 19 19 19 27 36 36 36 29 29 36 36 36 36 28 19 19 19 19 19 19 19 19 19 19 19 19 19 19 13 2 82 82 82 82 82 82 82 82 82 82 82 82 82 82 82 82 87 87 82 82 82 82 82 82 82 82 82 
41 2 2 2 2 2 2 2 2 2 2 2 2 2 2 2 2 2 2 17 19 19 19 19 19 19 19 19 19 19 19 19 19 19 19 19 19 19 19 19 19 19 19 19 19 19 91 94 91 94 32 33 91 94 91 94 91 19 19 19 19 19 19 19 19 19 19 19 19 19 19 13 2 82 82 82 82 82 82 82 82 82 82 82 82 82 82 82 82 87 87 82 82 82 82 82 82 82 82 82 
41 2 2 41 41 41 41 41 38 41 41 41 41 41 41 41 41 41 41 17 19 19 19 19 19 19 19 19 19 19 19 19 19 19 19 19 19 19 19 19 19 19 19 19 19 19 19 19 19 19 32 33 19 19 19 19 19 19 19 19 19 19 19 19 19 19 19 19 19 19 19 13 1 82 82 82 82 82 82 82 82 82 82 82 82 82 82 81 82 88 88 82 82 82 82 82 82 82 82 82 
41 2 2 41 2 1 2 2 1 1 1 1 2 2 2 2 2 1 41 16 15 15 15 59 19 19 19 19 19 19 19 19 19 19 19 19 19 19 19 19 19 19 19 19 19 19 19 19 19 19 32 33 19 19 19 19 19 19 19 19 19 19 19 19 19 19 19 19 19 19 19 13 1 82 82 82 82 82 82 82 82 82 82 82 82 82 82 82 82 88 88 82 82 82 82 82 82 82 82 82 
41 2 2 38 2 1 2 2 1 1 1 1 2 1 1 1 2 1 41 2 2 2 2 16 15 15 15 59 19 19 19 19 19 19 19 19 19 19 19 19 19 19 19 19 19 19 19 19 19 19 32 33 19 19 19 19 19 19 19 19 19 19 19 19 19 19 19 19 19 19 19 13 1 82 82 82 82 82 82 82 82 82 82 82 82 82 82 82 82 88 88 82 82 82 82 82 82 82 82 82 
41 2 1 41 2 2 41 39 41 41 39 41 41 41 41 41 2 2 40 41 41 39 41 41 41 41 41 16 59 19 19 19 19 19 19 19 19 19 19 19 19 19 19 19 19 19 19 19 19 19 32 33 19 19 19 19 19 19 19 19 19 19 19 19 19 19 19 19 19 19 19 13 2 82 82 82 82 82 82 82 82 82 82 82 82 82 82 82 82 88 88 82 82 82 82 82 82 82 82 82 
41 2 1 41 1 1 41 2 2 2 2 1 1 1 1 41 2 1 1 1 1 1 1 2 2 2 39 41 16 59 19 19 19 19 19 19 19 19 19 19 19 19 19 19 19 19 19 19 19 19 32 33 19 19 19 19 19 19 19 19 19 19 19 19 19 19 19 19 19 19 19 13 1 82 82 82 82 82 82 82 82 82 82 82 82 82 82 82 82 89 90 82 82 82 82 82 82 82 82 82 
41 1 2 41 2 2 41 2 2 2 2 2 2 2 1 41 1 2 2 2 2 2 1 2 2 2 2 40 2 16 15 15 15 15 15 15 15 15 15 15 15 15 15 15 59 19 19 19 19 19 32 33 19 19 19 19 19 19 19 19 19 19 19 19 19 19 19 19 19 19 19 13 2 82 82 82 82 82 82 86 86 86 86 86 86 87 87 88 88 87 87 87 86 86 86 86 86 82 82 82 
41 41 38 39 38 41 38 41 41 40 38 40 41 2 2 41 40 38 40 39 41 40 39 41 41 2 2 41 39 41 41 39 41 41 2 2 2 2 2 1 2 2 1 2 16 59 19 19 19 19 32 33 19 19 19 19 19 19 19 19 19 19 19 19 19 19 19 19 19 19 19 13 2 82 82 82 82 82 82 86 83 86 86 86 86 87 87 88 88 87 87 87 86 86 86 83 86 82 82 82 
40 2 1 2 2 2 2 2 2 2 2 2 2 1 1 1 2 2 1 2 2 1 76 74 40 75 1 1 1 1 2 2 2 41 40 1 1 1 1 2 2 1 2 1 2 16 59 19 19 19 32 33 19 19 19 19 19 19 19 19 19 19 19 19 19 19 19 19 19 19 19 13 1 82 82 82 82 82 82 86 86 86 86 86 87 87 87 88 88 87 87 87 87 86 86 86 86 82 82 82 
40 2 1 2 2 2 1 1 1 1 1 1 1 1 1 1 2 2 1 2 2 1 1 2 39 1 1 1 2 2 1 1 1 2 41 2 1 1 2 1 1 2 2 1 2 2 16 59 19 19 32 33 19 19 19 19 19 19 19 19 19 19 19 19 19 19 19 19 19 19 19 13 2 82 82 82 82 82 82 86 86 86 86 87 87 87 87 88 88 88 87 87 87 87 86 86 86 82 82 82 
40 2 1 41 38 40 40 39 41 41 41 41 41 40 38 40 41 41 41 41 2 2 1 1 41 41 41 40 40 39 41 2 1 2 39 2 2 2 2 2 2 2 2 1 1 2 2 17 19 60 32 33 59 19 19 19 19 19 19 19 19 19 19 19 19 19 19 19 19 19 19 13 1 82 82 82 82 82 82 86 86 87 87 87 87 87 88 88 88 88 87 87 87 87 87 86 86 82 82 82 
40 2 1 41 1 1 95 1 1 1 2 1 2 2 2 2 2 2 2 41 40 2 1 1 2 2 2 1 2 2 41 40 1 1 41 41 40 39 40 41 40 95 2 2 1 2 2 17 19 13 32 33 17 19 19 19 19 19 19 19 19 19 19 19 19 19 19 19 19 19 19 13 2 2 1 2 1 2 82 87 87 87 87 87 87 87 88 88 88 88 88 87 87 87 87 87 87 82 82 82 
39 1 2 41 2 1 1 1 1 2 2 2 1 1 2 2 1 2 1 2 41 2 2 2 2 2 2 2 1 1 2 40 1 1 1 1 2 2 1 1 2 2 2 2 1 2 2 17 19 13 2 2 16 59 19 19 19 19 19 19 19 19 19 19 19 19 19 19 93 92 19 13 2 1 2 1 2 1 82 87 87 87 87 87 87 88 88 88 88 88 88 88 88 88 88 88 88 82 82 82 
41 2 2 41 1 95 1 1 1 1 1 1 1 1 1 1 2 1 2 2 41 41 40 39 40 40 41 41 2 2 2 40 1 1 1 1 1 1 2 1 2 1 2 2 1 2 2 16 15 14 2 2 2 16 19 19 19 19 19 19 19 19 19 19 19 19 19 19 19 19 19 13 38 39 41 40 38 39 82 88 88 88 88 88 88 88 88 88 88 88 88 88 88 88 88 88 88 82 82 82 
39 1 2 41 1 1 1 1 1 95 1 1 2 2 2 1 2 2 2 2 2 2 2 2 2 2 2 2 2 2 41 41 41 40 40 40 41 39 41 41 39 95 2 2 1 1 2 2 2 2 2 2 1 37 37 37 37 37 37 37 37 37 37 37 37 37 37 37 37 37 37 37 37 1 1 1 65 1 82 87 87 87 88 88 88 88 88 88 88 88 88 88 88 88 87 87 87 82 82 82 
41 1 2 41 40 39 41 41 41 41 41 41 40 39 41 41 40 40 2 1 1 2 2 2 2 1 1 1 1 2 2 2 2 1 2 2 2 2 41 2 2 2 2 1 1 1 2 2 2 1 1 2 2 29 29 29 29 29 29 29 29 29 29 29 29 29 29 29 29 29 29 29 29 4 4 4 4 4 78 86 87 87 87 87 87 88 88 88 88 88 88 88 87 87 87 87 87 82 82 82 
40 1 2 2 2 2 2 2 2 41 2 2 2 2 2 2 2 41 2 2 1 2 2 1 1 1 2 2 1 2 2 2 2 2 1 1 2 2 41 2 1 1 1 2 2 2 2 2 2 2 1 2 2 29 29 29 29 29 29 29 29 29 29 29 29 29 29 29 29 29 29 29 29 4 4 4 4 4 80 86 86 87 87 87 87 87 88 88 88 88 88 87 87 87 87 86 86 82 82 82 
41 1 1 1 2 1 1 1 1 1 1 1 1 1 1 1 2 41 2 2 1 1 1 1 2 2 2 2 2 41 40 40 41 2 1 1 2 2 41 2 1 2 2 2 1 1 1 1 1 1 2 1 2 36 36 36 36 36 36 36 36 36 36 36 36 36 36 36 36 36 36 36 36 1 1 1 1 1 82 86 86 86 87 87 87 87 87 88 88 88 87 87 87 87 86 86 86 82 82 82 
40 40 2 1 2 40 40 2 2 2 2 1 1 1 2 2 2 41 40 41 41 41 40 40 41 41 40 2 2 38 2 1 1 2 1 41 39 41 41 2 1 2 2 2 1 2 2 2 2 2 2 2 2 57 94 94 91 94 94 91 94 94 91 94 94 91 94 94 91 94 94 96 40 41 39 41 41 40 82 86 86 86 86 87 87 87 87 88 88 87 87 87 87 86 86 86 86 82 82 82 
40 40 2 1 41 40 39 41 2 2 2 41 40 41 39 2 2 2 2 2 2 2 2 2 2 2 41 1 2 40 2 1 2 2 1 41 1 1 39 2 1 1 2 2 2 2 57 11 11 11 49 11 11 62 19 19 19 19 19 19 19 19 19 19 19 19 19 19 19 19 19 13 1 2 2 1 2 1 82 86 83 86 86 86 87 87 87 88 88 87 87 87 86 86 86 83 86 82 82 82 
41 40 2 1 41 2 2 2 2 1 1 1 2 2 41 2 2 2 1 1 1 2 1 1 1 2 41 1 2 39 2 1 41 1 2 38 2 2 41 2 2 1 1 2 2 2 17 19 19 50 19 19 50 19 19 19 19 19 19 19 19 19 19 19 19 19 19 19 19 19 19 13 2 1 1 1 1 2 82 86 86 86 86 86 86 87 87 88 88 87 87 87 86 86 86 86 86 82 82 82 
39 40 1 2 40 2 2 2 2 2 2 1 2 2 41 40 38 41 40 40 39 41 41 41 2 2 39 2 1 40 1 1 38 1 2 40 2 2 40 2 2 2 2 2 2 2 16 19 19 19 19 19 19 19 19 19 19 19 19 19 19 19 19 19 19 19 19 19 19 19 19 13 2 82 82 82 82 82 82 82 82 82 82 82 82 82 82 82 82 82 82 82 82 82 82 82 82 82 82 82 
41 40 1 2 41 39 2 2 2 41 2 2 2 2 1 1 1 2 2 2 41 2 2 2 2 2 41 2 1 41 2 2 40 1 2 40 2 1 41 1 2 2 2 2 2 1 2 37 37 37 37 37 37 25 19 19 19 19 19 19 19 19 19 19 19 19 19 19 19 19 19 13 2 82 82 82 82 82 82 82 82 82 82 82 82 82 82 82 82 82 82 82 82 82 82 82 82 82 82 82 
41 2 1 2 2 41 2 2 2 40 1 2 2 2 2 2 1 2 2 2 41 2 1 1 2 2 40 2 1 41 41 40 41 1 2 39 2 1 40 40 41 38 40 39 1 1 2 36 36 36 36 36 29 33 19 19 19 19 19 19 19 19 19 19 19 19 19 19 19 19 19 13 1 82 82 82 82 82 82 82 82 82 82 82 82 82 82 82 82 82 82 82 82 82 82 82 82 82 82 82 
41 1 2 2 2 40 2 2 2 41 1 2 41 40 41 41 41 40 2 2 41 1 2 40 41 40 41 1 1 2 2 2 41 1 2 41 2 1 41 1 2 1 2 41 2 2 57 94 91 94 91 94 32 33 19 19 19 19 19 19 19 19 19 19 19 19 19 19 19 19 19 13 2 82 82 82 82 82 82 82 82 82 82 82 82 82 82 82 82 82 82 82 82 82 82 82 82 82 82 82 
40 2 2 41 40 41 41 2 2 41 1 1 2 2 2 2 2 41 2 2 41 1 1 40 2 2 1 1 2 2 2 2 41 1 2 41 2 1 41 2 2 2 2 2 2 2 17 19 19 19 19 19 32 33 19 19 19 19 19 19 19 19 19 19 19 19 19 19 19 19 19 13 2 82 82 82 82 82 82 82 82 82 82 82 82 82 82 82 82 82 82 82 82 82 82 82 82 82 82 82 
41 2 2 2 2 2 2 2 2 39 2 1 2 2 2 2 2 41 41 38 41 2 1 39 2 1 2 2 2 39 40 41 41 2 2 41 2 1 40 2 2 1 1 2 2 2 17 19 19 19 19 19 32 33 19 19 19 19 19 19 19 19 19 19 19 19 19 19 19 19 19 13 1 82 82 82 82 82 82 82 82 82 82 82 82 82 82 82 82 82 82 82 82 82 82 82 82 82 82 82 
41 2 2 2 2 2 2 1 2 40 2 1 41 41 41 2 2 2 39 2 2 2 2 40 41 40 40 40 40 41 2 2 2 2 2 1 2 1 2 2 2 40 2 2 2 57 62 19 19 19 19 19 32 29 37 37 37 37 37 25 19 19 19 19 19 19 19 19 19 19 19 13 2 82 82 82 82 82 82 82 82 82 82 82 82 82 82 82 82 82 82 82 82 82 82 82 82 82 82 82 
39 41 40 38 39 41 40 1 2 41 2 1 41 2 40 2 2 2 40 2 2 2 2 2 2 2 2 2 2 41 2 2 1 1 1 1 2 2 2 2 1 39 2 1 57 62 19 19 19 19 19 19 27 36 36 36 36 36 29 33 19 19 19 19 19 19 19 19 19 19 19 13 2 82 82 82 82 82 82 82 82 82 82 82 82 82 82 82 82 82 82 82 82 82 82 82 82 82 82 82 
41 2 2 2 2 2 1 1 2 40 2 1 2 2 41 1 2 2 40 2 1 41 2 2 1 1 1 2 2 40 40 39 41 41 41 40 41 41 39 41 40 41 2 57 62 19 19 19 19 19 19 19 91 94 91 94 91 94 32 33 19 19 19 19 19 19 19 19 19 19 19 13 2 82 82 82 82 82 82 82 82 82 82 82 82 82 82 82 82 82 82 82 82 82 82 82 82 82 82 82 
40 2 2 2 1 1 1 2 2 39 2 2 2 2 38 1 1 2 41 1 1 41 41 38 40 38 41 2 2 2 2 1 1 1 2 18 11 12 2 2 41 2 57 62 19 19 19 19 19 19 19 19 19 19 19 19 19 19 34 33 19 19 19 19 19 19 19 19 19 19 19 64 11 11 11 11 11 11 11 11 11 11 11 11 11 11 11 11 11 11 11 11 11 11 11 11 11 11 11 11 
39 2 2 41 38 40 41 40 41 40 38 40 2 2 40 2 1 2 40 1 2 2 2 2 2 2 41 2 2 1 1 2 2 1 18 62 19 64 12 2 41 57 62 19 19 19 19 19 19 19 19 19 19 19 19 19 93 19 32 33 19 19 19 19 19 19 19 19 19 19 19 19 19 19 19 19 19 19 19 19 19 19 19 19 19 19 19 19 19 19 19 19 19 19 19 19 19 19 19 19 
41 2 2 2 2 2 2 2 2 2 2 2 2 2 41 2 1 2 39 1 1 1 1 1 2 2 40 41 41 40 40 2 1 1 17 19 19 19 64 11 11 62 19 19 19 19 19 19 19 19 19 19 19 19 19 19 19 19 32 33 19 92 19 19 19 19 19 19 19 19 19 19 19 19 19 19 19 19 19 19 19 19 19 19 19 19 19 19 19 19 19 19 19 19 19 19 19 19 19 19 
40 2 2 2 2 2 2 2 2 2 2 2 2 2 39 2 2 2 40 40 41 41 40 39 2 2 38 2 2 2 40 2 1 2 17 19 19 19 19 19 19 19 19 19 19 19 19 19 19 19 19 19 19 19 19 19 19 19 32 33 19 19 19 19 19 19 19 19 19 19 19 19 19 19 19 19 19 19 19 19 19 19 19 19 19 19 19 19 19 19 19 19 19 19 19 19 19 19 19 19 
41 2 2 41 40 41 38 40 41 1 2 41 41 41 41 2 2 1 2 2 2 2 2 41 1 2 41 2 95 2 41 1 1 57 62 19 19 19 19 19 19 19 19 19 19 19 19 19 19 19 19 19 19 19 19 19 19 19 32 31 19 19 19 19 19 19 19 19 19 19 19 19 19 19 19 19 19 19 19 19 19 19 19 19 19 19 19 19 19 19 19 19 19 19 19 19 19 19 19 19 
40 1 2 2 2 2 2 2 41 1 2 38 2 1 1 2 2 2 1 2 2 2 2 2 1 2 40 2 1 2 2 1 57 62 19 19 19 19 19 19 19 19 19 19 19 19 19 19 19 19 19 19 19 19 19 19 19 19 32 33 19 19 19 19 19 19 19 19 19 19 19 19 19 19 19 19 19 19 19 19 19 19 19 19 19 19 19 19 19 19 19 19 19 19 19 19 19 19 19 19 
58 1 1 2 2 2 2 2 41 1 2 40 2 1 2 2 2 2 41 1 2 2 1 1 1 2 40 2 1 2 2 57 62 19 19 19 19 19 19 19 19 19 19 19 19 19 19 19 19 19 19 19 19 19 19 19 60 15 32 33 15 15 15 15 15 15 15 15 59 19 19 19 19 19 19 19 19 19 19 19 19 19 19 19 19 19 19 19 19 19 19 19 19 19 19 19 19 19 19 19 
64 58 2 39 41 40 39 2 40 1 2 38 2 1 39 39 40 40 57 11 11 11 11 11 11 12 41 2 2 2 57 62 19 19 19 19 19 19 19 19 19 19 19 19 19 19 19 19 19 19 19 19 19 19 19 60 14 2 32 33 2 1 1 2 2 1 1 1 16 59 19 19 19 19 19 19 19 19 19 19 19 19 19 19 19 19 19 19 19 19 19 19 19 19 19 19 19 19 19 19 
19 64 58 2 1 1 41 1 39 2 2 40 2 1 41 2 2 57 62 19 19 19 19 19 19 64 11 11 11 11 62 19 19 19 19 19 19 19 19 19 19 19 19 19 19 19 19 19 19 19 19 19 19 19 60 14 1 2 32 33 2 2 65 2 2 2 2 2 2 16 15 15 59 19 19 19 19 19 19 19 19 19 19 19 19 19 19 19 19 19 19 19 19 19 19 19 19 19 19 19 
19 19 64 58 2 1 41 1 40 2 2 41 1 2 39 2 57 62 19 19 19 19 19 19 19 19 19 19 19 19 19 19 19 19 19 19 19 19 19 19 19 19 19 19 19 19 19 19 19 19 19 19 19 60 14 2 1 2 2 1 2 2 1 1 1 1 2 2 1 2 2 2 16 59 19 19 19 19 19 19 19 19 19 19 19 19 19 19 19 19 19 19 19 19 19 19 19 19 19 19 
19 19 19 64 58 1 1 1 41 2 2 39 2 2 41 57 62 19 19 19 19 19 19 19 19 19 19 19 19 19 19 19 19 19 19 19 19 19 19 19 19 19 19 19 19 19 19 19 19 19 19 60 15 14 2 1 1 2 1 2 2 1 2 2 2 2 2 2 2 1 1 2 2 16 59 19 19 19 19 19 19 19 19 19 19 19 19 19 19 19 19 19 19 19 19 19 19 19 19 19 
19 19 19 19 64 58 2 1 39 2 2 41 2 1 57 62 19 19 19 19 19 19 19 19 19 19 19 19 19 19 19 19 19 19 19 19 19 19 19 19 19 19 19 19 19 19 19 19 19 19 60 14 2 1 1 1 2 2 2 1 1 2 45 45 2 45 2 1 1 2 2 1 2 2 16 59 19 19 19 19 19 19 19 19 19 19 19 19 19 19 19 19 19 19 19 19 19 19 19 19 
19 19 19 19 19 64 58 2 39 32 33 39 2 57 62 19 19 19 19 19 19 19 19 19 19 19 19 19 19 19 19 19 19 19 19 19 19 19 19 19 19 19 19 19 19 19 19 19 19 60 14 2 1 1 2 1 45 45 45 45 45 45 45 45 45 45 45 45 1 1 1 2 2 2 2 16 59 19 19 19 19 19 19 19 19 19 19 19 19 19 19 19 19 19 19 19 19 19 19 19 
19 19 19 19 19 19 64 11 11 32 33 11 11 62 19 19 19 19 19 19 19 19 19 19 19 19 19 19 19 19 19 19 19 19 19 19 19 19 19 19 19 19 19 19 19 19 19 19 60 14 2 2 2 1 45 45 45 45 45 45 45 45 45 45 45 45 45 45 45 45 45 45 2 2 1 1 16 59 19 19 19 19 19 19 19 19 19 19 19 19 19 19 19 19 19 19 19 19 19 19 
19 19 19 19 19 19 19 19 19 32 33 19 19 19 19 19 19 19 19 19 19 19 19 19 19 19 19 19 19 19 19 19 19 19 19 19 19 19 19 19 19 19 19 19 19 19 19 60 14 2 1 1 45 45 45 45 45 45 45 45 46 46 46 46 45 45 45 45 45 45 45 45 45 2 2 2 2 16 59 19 19 19 19 19 19 19 19 19 19 19 19 19 19 19 19 19 19 19 19 19 
19 19 19 19 19 19 19 19 19 32 33 19 19 19 19 19 19 19 19 19 19 19 19 19 19 19 19 19 19 19 19 19 19 19 19 19 19 19 19 19 19 19 19 19 19 60 15 14 2 2 1 45 45 45 45 45 46 46 46 46 46 46 46 46 46 46 46 46 46 45 45 45 45 45 1 1 2 2 16 59 19 19 19 19 19 19 19 19 19 19 19 19 19 19 19 19 19 19 19 19 
19 19 19 19 19 19 19 19 19 32 33 19 19 19 19 19 19 19 19 19 19 19 19 19 19 19 19 19 19 19 19 19 19 19 19 19 19 19 19 19 19 19 19 19 60 14 2 1 45 45 45 45 45 45 46 46 46 46 46 46 47 47 47 47 47 47 46 46 46 46 46 45 45 45 45 1 1 2 2 16 59 19 19 19 19 19 19 19 19 19 19 19 19 19 19 19 19 19 19 19 
19 19 19 19 19 19 19 19 19 34 33 19 19 19 19 19 19 19 19 19 19 19 19 19 19 19 19 19 19 19 19 19 19 19 19 19 19 19 19 19 19 19 19 60 14 2 2 2 45 45 45 45 46 46 46 46 43 43 47 47 47 47 43 43 43 43 47 47 47 46 46 46 46 45 45 45 2 1 1 2 16 59 19 19 19 19 19 19 19 19 19 19 19 19 19 19 19 19 19 19 
19 19 19 19 19 19 19 19 19 32 33 19 19 19 19 19 19 19 19 19 19 19 19 19 19 19 19 19 19 19 19 19 19 19 19 19 19 19 19 19 19 19 60 14 2 1 2 45 45 45 46 46 43 46 46 43 43 47 47 47 47 47 47 47 47 47 43 43 47 47 46 46 46 45 45 45 45 45 1 2 2 16 59 19 19 19 19 19 19 19 19 19 19 19 19 19 19 19 19 19 
19 19 19 19 19 19 19 19 19 32 31 19 19 19 19 19 19 19 19 19 19 19 19 19 19 19 19 19 19 19 19 19 19 19 19 19 19 19 19 19 19 60 14 2 1 1 45 45 45 46 46 43 43 46 43 48 48 42 48 48 48 48 47 42 48 48 48 43 47 47 43 43 46 46 45 45 45 45 2 1 2 2 17 19 19 19 19 19 19 19 19 19 19 19 19 19 19 19 19 19 
19 19 19 19 19 19 19 19 19 32 33 19 19 19 19 19 19 19 19 19 19 19 19 19 19 19 19 19 19 19 19 19 19 19 19 19 19 19 19 19 19 13 2 1 1 45 45 45 46 46 46 43 47 48 47 43 48 48 48 43 48 48 48 42 48 42 42 48 47 48 48 43 46 46 46 46 45 45 45 1 2 1 17 19 19 19 19 19 19 19 19 19 19 19 19 19 19 19 19 19 
39 39 39 39 39 39 39 15 15 32 33 15 15 39 39 39 39 39 39 39 39 39 39 39 39 39 39 41 41 59 19 19 19 19 19 19 19 19 19 19 19 13 2 2 45 45 45 45 46 43 43 47 47 47 48 47 42 44 43 43 43 42 42 43 48 42 42 48 48 47 48 47 43 43 46 46 45 43 43 2 1 1 17 19 19 19 19 19 19 19 19 19 19 19 19 19 19 19 19 19 
39 1 2 2 2 1 2 1 1 32 33 1 1 2 2 2 1 1 2 39 1 1 2 1 1 1 1 2 2 17 19 19 19 19 19 19 19 19 19 19 19 13 1 1 1 45 45 45 43 46 47 47 47 42 42 42 48 43 44 43 43 43 43 43 48 48 48 42 48 47 47 47 47 43 43 46 43 43 45 45 2 1 17 19 19 19 19 19 19 19 19 19 19 19 19 19 19 19 19 19 
39 2 2 1 1 2 2 2 1 52 54 1 2 1 2 1 1 2 1 39 1 1 1 1 2 1 1 1 1 17 19 19 19 19 19 19 19 19 19 19 19 13 1 2 2 45 45 45 46 46 47 47 47 42 48 43 42 43 43 44 44 44 43 43 43 43 48 42 42 48 48 47 47 46 43 43 43 45 45 45 2 1 17 19 19 19 19 19 19 19 19 19 19 19 19 19 19 19 19 19 
9 7 9 7 9 9 7 9 9 52 55 9 9 7 9 7 7 9 9 8 7 7 5 5 6 5 2 2 1 17 19 19 19 19 19 19 19 19 19 19 19 13 1 2 45 45 45 45 46 43 47 47 47 42 48 42 43 43 44 44 44 44 44 43 43 48 47 48 42 42 47 47 47 43 43 46 45 45 45 45 2 2 17 19 19 19 19 19 19 19 19 19 19 19 19 19 19 19 19 19 
9 9 9 9 9 5 9 9 9 52 51 9 9 9 9 7 9 7 9 5 5 7 7 6 6 5 2 2 2 17 19 19 19 19 19 19 19 19 19 19 19 13 2 2 2 2 45 45 46 47 43 47 42 42 42 42 43 43 44 44 44 44 44 43 43 48 42 48 42 47 47 47 47 43 46 46 45 45 45 45 45 2 17 19 19 19 19 19 19 19 19 19 19 19 19 19 19 19 19 19 
9 9 9 9 9 7 7 6 6 52 55 9 9 5 5 9 5 7 7 5 5 6 6 6 7 5 2 2 2 17 19 19 19 19 19 19 19 19 19 19 19 13 2 1 2 45 45 45 46 46 47 47 42 42 42 43 43 44 44 44 44 44 44 43 43 43 42 42 42 48 47 47 43 46 46 46 45 45 45 45 2 2 17 19 19 19 19 19 19 19 19 19 19 19 19 19 19 19 19 19 
7 7 6 9 6 6 7 9 9 52 54 9 5 5 5 6 5 7 5 5 5 5 7 7 5 5 2 2 2 17 19 19 19 19 19 19 19 19 19 19 19 13 2 2 1 45 45 45 46 46 47 47 47 42 42 44 44 44 43 44 44 43 44 44 44 43 48 48 48 47 47 47 46 46 46 46 45 45 45 1 2 2 17 19 19 19 19 19 19 19 19 19 19 19 19 19 19 19 19 19 
9 9 9 9 9 9 9 8 7 52 55 5 8 9 5 5 9 7 9 5 7 7 5 5 5 5 2 2 2 17 19 19 19 19 19 19 19 19 19 19 19 13 2 1 1 1 1 45 45 45 47 47 47 44 44 44 43 43 43 43 43 43 43 44 44 44 42 42 47 47 47 46 46 43 46 45 45 45 45 1 2 1 17 19 19 19 19 19 19 19 19 19 19 19 19 19 19 19 19 19 
9 9 5 5 6 7 9 9 5 20 24 5 9 9 9 7 5 9 7 9 7 5 5 5 6 5 2 2 2 17 19 19 19 19 19 19 19 19 19 19 19 64 12 2 1 2 2 2 45 44 44 45 44 44 42 42 42 43 43 43 43 43 43 43 43 44 44 44 47 47 47 46 43 43 45 45 45 45 2 1 2 57 62 19 19 19 19 19 19 19 19 19 19 19 19 19 19 19 19 19 
9 9 9 9 9 9 9 7 5 77 79 5 5 5 5 7 9 9 9 8 7 7 5 6 5 5 2 2 2 17 19 19 19 19 19 19 19 19 19 19 19 19 64 12 1 1 44 44 44 44 44 44 44 45 46 42 42 48 42 43 43 42 48 43 44 42 42 44 44 47 47 46 43 45 45 45 45 2 1 1 57 62 19 19 19 19 19 19 19 19 19 19 19 19 19 19 19 19 19 19 
9 9 20 20 20 20 20 20 20 20 20 20 20 20 20 20 20 20 9 8 5 6 5 7 7 5 2 2 2 17 19 19 19 19 19 19 19 19 19 19 19 19 19 64 58 1 1 44 44 44 45 45 45 44 47 43 47 48 47 42 48 48 42 47 44 42 42 44 44 47 46 45 45 45 45 2 1 1 1 57 62 19 19 19 19 19 19 19 19 19 19 19 19 19 19 19 19 19 19 19 
9 9 20 20 20 20 20 20 20 20 20 20 20 20 20 20 20 20 9 8 5 6 5 5 5 5 2 2 2 17 19 19 19 19 19 19 19 19 19 19 19 19 19 19 64 58 2 2 2 44 44 45 44 44 45 43 43 48 47 47 47 47 47 44 47 47 47 46 44 45 45 45 44 44 2 1 1 2 57 62 19 19 19 19 19 19 19 19 19 19 19 19 19 19 19 19 19 19 19 19 
9 9 20 20 20 20 20 20 20 20 20 20 20 20 20 20 20 20 7 8 5 5 6 5 5 5 2 2 2 17 19 19 19 19 19 19 19 19 19 19 19 19 19 19 19 64 58 2 1 2 44 44 44 45 45 45 45 47 43 47 47 46 47 44 46 46 46 45 44 44 45 44 44 2 1 2 2 57 62 19 19 19 19 19 19 19 19 19 19 19 19 19 19 19 19 19 19 19 19 19 
9 9 20 20 20 20 20 20 20 20 20 20 20 20 20 20 20 20 9 8 5 5 7 6 6 5 2 2 2 17 19 19 19 19 19 19 19 19 19 19 19 19 19 19 19 19 64 58 1 1 1 2 44 44 44 2 45 45 43 43 43 46 46 44 46 45 45 45 45 44 44 44 44 1 1 2 57 62 19 19 19 19 19 19 19 19 19 19 19 19 19 19 19 19 19 19 19 19 19 19 
9 9 20 20 20 20 20 20 20 20 20 20 20 20 20 20 20 20 5 5 5 5 6 5 5 5 2 2 2 17 19 19 19 19 19 19 19 19 19 19 19 19 19 19 19 19 19 64 58 2 1 1 2 1 1 2 2 45 45 45 45 44 44 44 45 45 45 44 44 44 44 44 2 2 2 57 62 19 19 19 19 19 19 19 19 19 19 19 19 19 19 19 19 19 19 19 19 19 19 19 
9 5 20 20 20 20 20 20 20 20 20 20 20 20 20 20 20 20 5 5 5 5 5 7 7 5 2 2 2 17 19 19 19 19 19 19 19 19 19 19 19 19 19 19 19 19 19 19 64 58 2 2 1 1 2 2 2 2 2 44 44 44 44 45 44 44 44 44 44 44 1 1 2 1 57 62 19 19 19 19 19 19 19 19 19 19 19 19 19 19 19 19 19 19 19 19 19 19 19 19 
9 5 20 20 20 20 20 20 20 20 20 20 20 20 21 20 20 20 7 5 5 5 6 6 5 5 2 2 2 17 19 19 19 19 19 19 19 19 19 19 19 19 19 19 19 19 19 19 19 64 58 2 1 2 1 1 1 1 1 1 1 1 44 44 44 44 44 44 1 1 1 1 1 57 62 19 19 19 19 19 19 19 19 19 19 19 19 19 19 19 19 19 19 19 19 19 19 19 19 19 
9 5 20 20 20 20 20 20 20 20 20 20 20 20 20 20 20 20 7 5 5 5 5 6 6 5 2 2 2 17 19 19 19 19 19 19 19 19 19 19 19 19 19 19 19 19 19 19 19 19 64 58 1 2 2 73 73 73 73 73 73 73 73 73 73 73 73 73 73 73 73 73 11 62 19 19 19 19 19 19 19 19 19 19 19 19 19 19 19 19 19 19 19 19 19 19 19 19 19 19 
8 5 22 23 20 20 20 20 20 20 20 20 20 20 20 20 20 20 9 5 5 5 5 5 6 5 2 2 2 17 19 19 19 19 19 19 19 19 19 19 19 19 19 19 19 19 19 19 19 19 19 64 11 11 11 71 66 66 66 66 66 66 66 66 66 67 66 66 66 66 66 72 19 19 19 19 19 19 19 19 19 19 19 19 19 19 19 19 19 19 19 19 19 19 19 19 19 19 19 19 
9 8 8 9 9 9 6 6 6 5 5 9 9 5 5 5 9 9 9 5 5 7 6 5 5 5 2 2 2 17 19 19 19 19 19 19 19 19 19 19 19 19 19 19 19 19 19 19 19 19 19 19 19 19 19 69 68 68 68 68 68 68 68 68 68 68 68 68 68 68 68 70 19 19 19 19 19 19 19 19 19 19 19 19 19 19 19 19 19 19 19 19 19 19 19 19 19 19 19 19 
8 9 9 8 9 9 9 9 8 9 8 8 9 5 9 9 9 9 7 5 5 5 6 5 5 5 2 2 2 17 19 19 19 19 19 19 19 19 19 19 19 19 19 19 19 19 19 19 19 19 19 19 19 19 19 19 19 19 19 19 19 19 19 19 19 19 19 19 19 19 19 19 19 19 19 19 19 19 19 19 19 19 19 19 19 19 19 19 19 19 19 19 19 19 19 19 19 19 19 19 
